%%%%%%%
%P   .%
% .%. %
%. % .%
%    .%
%%%%%%%